C 130,202,255
F 0,127,0

NO assets/black_wood.png
SO assets/brick_wall_2.png
WE assets/wood_brick.png
EA assets/plant_wall.png

111111111111111111
100000000000000001
100000000000000001
100000000000000001
100000000000000001
100111100001111001
100111100001111001
100111100001111001
100111100001111001
100000011110000001
100000011110000001
100001111111100001
100001111111100001
100001111111100001
100001111111100001
100001100001100001
1000011000011000S1
111111111111111111