C 130,202,255
F 0,127,0

NO assets/black_wood.png
SO assets/brick_wall_2.png
WE assets/wood_brick.png
EA assets/plant_wall.png

111111111111111111111111111111111111111111111111111111111111111111111111111111111111111111111111111111111111111
111111111111111111111111111111111111111111111111111111000111111111111111111111111111111111111111111111111111111
1111111111111111111111111111111111111111111111111111110N0111111111111111111111111111111111111111111111111111111
111111111111111111111111111111111111111111111111111111000111111111111111111111111111111111111111111111111111111
111111111111111111111111111111111111111111111111111111111111111111111111111111111111111111111111111111111111111