NO assets/black_wood.png
SO assets/brick_wall_2.png
WE assets/wood_brick.png
EA assets/plant_wall.png
F 255,255,255
C 0,0,0

111111111111111111111111111111111111111
1E0000000000000000000000000000000000001
100000000000000000000000000000000000001
100000000000000000000000000000000000001
100000000000000000000000000000000000001
111111111111111111111111111111110000001
                              100000001
                             100000001
                            100000001 
                           100000001  
                          100000001   
                         100000001    
                        100000001     
                       100000001      
                      100000001       
                     100000001        
                    100000001         
                   100000001          
                  100000001           
                 100000001            
                100000001             
               100000001              
              100000001               
             100000001                
            100000001                 
           100000001                  
          100000001                   
         100000001                    
        100000001                     
       100000001                      
      100000001                       
     100000001                        
    100000001                         
   100000001                          
  100000001                           
 100000001                            
100000001                             
100000001111111111111111111111111111111
100000000000000000000000000000000000001
100000000000000000000000000000000000001
100000000000000000000000000000000000001
100000000000000000000000000000000000001
111111111111111111111111111111111111111