NO ./assets/brick_wall_2.png
SO ./assets/brick_wall_2.png
WE ./assets/brick_wall_2.png
EA ./assets/brick_wall_2.png

F 220,100,0
C 225,30,0

        1111111111111111111111111
        1000000000000000000000001
        1000000000000001111111101
        1000000000000001000000101
        1000000000000001011111101
111111111000000001110001000000001
100000000000000001110111111111111
10000000000000000000000000001
10000000000000000000000000001
11000000111111111100000000001
10001000000000001100000000001
10011100000000000001010000001
11000001110101011111001110N0111
11110111 1110101 100001010001
11111111 1111111 111111111111