NO assets/plant_wall.png
SO assets/plant_wall.png
WE assets/plant_wall.png
EA assets/plant_wall.png

F 139,69,19
C 135,206,235

1111111111111111111111111111
1E00000000000000000000000001
1000000000000000000000000001
1000000000000000000000000001
1111111111111111111000000001
                  100000001
                 100000001
                100000001
               100000001
              100000001
             100000001
            100000001
           100000001
          100000001
         100000001
        100000001
       100000001
      100000001
     100000001
    100000001
   100000001
  100000001
 100000001
100000001
1000000011111111111111111111
1000000000000000000000000001
1000000000000000000000000001
1000000000000000000000000001
1111111111111111111111111111