NO assets/plant_wall.png
SO assets/plant_wall.png
WE assets/plant_wall.png
EA assets/plant_wall.png
F 220,100,0
C 225,30,0
1111111111111111111111111
1000000000110000000000001
1011000001110000000000001
1001000000000000000000001
1111111110110000011100001
1000000000110000011100001
111111111111111111111111111111111
11111111111111111111111111111
11000000110101011100000000001
10000000000000001100000000001
10000000000000001101010010001
11000001110101011111011110N0111
11110111 1110101 001111010021
11111111 1111111 111111111111