111111111111111111111111
100000000000000000000001
100000000000000000000001
100000000000000000000001
100000111110000101010001
100000100010000000000001
100000100010000100010001
100000100010000000000001
100000110110000101010001
100000000000000000000001
100000000000000000000001
100000000000000000000001
100000000000N00000000001
100000000000000000000001
100000000000000000000001
100000000000000000000001
111111111000000010001001
110100001000000001010001
110000101000000000200001
110100001000000001010001
110111111000000010001001
110000000000000000000001
111111111000000000000001
111111111111111111111111